{
  "mode": "Pvp",
  "tilemap": [
    [ 0, 0, 0, 0, 0, 0, 0, 0, 0, 0, 0, 0, 0, 0, 0, 0, 0, 0, 0, 0, 0, 0, 0, 0, 0, 0, 0, 0, 0, 0, 0, 0, 0, 0, 0, 0, 0, 0, 0, 0, 0, 0, 0, 0, 0, 0, 0, 0, 0, 0, 0, 0, 0, 0, 0, 0, 0, 0 ],
    [ 0, 1, 1, 1, 1, 1, 1, 1, 1, 1, 1, 1, 1, 1, 1, 1, 1, 1, 1, 1, 1, 1, 1, 1, 1, 1, 1, 1, 1, 1, 1, 1, 1, 1, 1, 1, 1, 1, 1, 1, 1, 1, 1, 1, 1, 1, 1, 1, 1, 1, 1, 0, 0, 1, 1, 1, 1, 0 ],
    [ 0, 1, 2, 2, 2, 2, 2, 2, 2, 2, 2, 2, 2, 2, 2, 2, 2, 2, 2, 2, 2, 2, 2, 2, 2, 2, 2, 2, 2, 2, 2, 2, 2, 2, 2, 2, 2, 2, 2, 2, 2, 2, 2, 2, 2, 2, 2, 2, 2, 2, 1, 0, 0, 1, 2, 2, 1, 0 ],
    [ 0, 1, 2, 2, 2, 2, 2, 2, 2, 2, 2, 2, 2, 2, 2, 2, 2, 2, 2, 2, 2, 2, 2, 2, 2, 2, 2, 2, 2, 2, 2, 2, 2, 2, 2, 2, 2, 2, 2, 2, 2, 2, 2, 2, 2, 2, 2, 2, 2, 2, 1, 0, 0, 1, 2, 2, 1, 0 ],
    [ 0, 1, 2, 2, 1, 1, 1, 1, 2, 2, 1, 1, 1, 1, 1, 1, 1, 1, 1, 1, 2, 2, 1, 1, 1, 1, 2, 2, 1, 1, 1, 1, 2, 2, 1, 1, 1, 1, 1, 1, 1, 1, 1, 1, 1, 1, 1, 1, 2, 2, 1, 0, 0, 1, 2, 2, 1, 0 ],
    [ 0, 1, 2, 2, 1, 0, 0, 1, 2, 2, 1, 0, 0, 0, 0, 0, 0, 0, 0, 1, 2, 2, 1, 0, 0, 1, 2, 2, 1, 0, 0, 1, 2, 2, 1, 0, 0, 0, 0, 0, 0, 0, 0, 0, 0, 0, 0, 1, 2, 2, 1, 0, 0, 1, 2, 2, 1, 0 ],
    [ 0, 1, 2, 2, 1, 0, 0, 1, 2, 2, 1, 0, 0, 0, 0, 0, 0, 0, 0, 1, 2, 2, 1, 0, 0, 1, 2, 2, 1, 0, 0, 1, 2, 2, 1, 0, 0, 0, 0, 0, 0, 0, 0, 0, 0, 0, 0, 1, 2, 2, 1, 0, 0, 1, 2, 2, 1, 0 ],
    [ 0, 1, 2, 2, 1, 0, 0, 1, 2, 2, 1, 1, 1, 1, 1, 1, 1, 0, 0, 1, 2, 2, 1, 1, 1, 1, 2, 2, 1, 1, 1, 1, 2, 2, 1, 1, 1, 1, 1, 1, 1, 1, 1, 1, 1, 1, 1, 1, 2, 2, 1, 1, 1, 1, 2, 2, 1, 0 ],
    [ 0, 1, 2, 2, 1, 0, 0, 1, 2, 2, 2, 2, 2, 2, 2, 2, 1, 0, 0, 1, 2, 2, 2, 2, 2, 2, 2, 2, 2, 2, 2, 2, 2, 2, 2, 2, 2, 2, 2, 2, 2, 2, 2, 2, 2, 2, 2, 2, 2, 2, 2, 2, 2, 2, 2, 2, 1, 0 ],
    [ 0, 1, 2, 2, 1, 1, 1, 1, 2, 2, 2, 2, 2, 2, 2, 2, 1, 0, 0, 1, 2, 2, 2, 2, 2, 2, 2, 2, 2, 2, 2, 2, 2, 2, 2, 2, 2, 2, 2, 2, 2, 2, 2, 2, 2, 2, 2, 2, 2, 2, 2, 2, 2, 2, 2, 2, 1, 0 ],
    [ 0, 1, 2, 2, 2, 2, 2, 2, 2, 2, 1, 1, 1, 1, 2, 2, 1, 0, 0, 1, 2, 2, 1, 1, 1, 1, 2, 2, 1, 1, 1, 1, 1, 1, 1, 1, 2, 2, 1, 1, 1, 1, 2, 2, 1, 1, 1, 1, 2, 2, 1, 1, 1, 1, 2, 2, 1, 0 ],
    [ 0, 1, 2, 2, 2, 2, 2, 2, 2, 2, 1, 0, 0, 1, 2, 2, 1, 0, 0, 1, 2, 2, 1, 0, 0, 1, 2, 2, 1, 0, 0, 0, 0, 0, 0, 1, 2, 2, 1, 0, 0, 1, 2, 2, 1, 0, 0, 1, 2, 2, 1, 0, 0, 1, 2, 2, 1, 0 ],
    [ 0, 1, 2, 2, 1, 1, 1, 1, 2, 2, 1, 0, 0, 1, 2, 2, 1, 0, 0, 1, 2, 2, 1, 0, 0, 1, 2, 2, 1, 0, 0, 0, 0, 0, 0, 1, 2, 2, 1, 0, 0, 1, 2, 2, 1, 0, 0, 1, 2, 2, 1, 0, 0, 1, 2, 2, 1, 0 ],
    [ 0, 1, 2, 2, 1, 0, 0, 1, 2, 2, 1, 1, 1, 1, 2, 2, 1, 1, 1, 1, 2, 2, 1, 1, 1, 1, 2, 2, 1, 1, 1, 1, 1, 1, 1, 1, 2, 2, 1, 1, 1, 1, 2, 2, 1, 0, 0, 1, 2, 2, 1, 1, 1, 1, 2, 2, 1, 0 ],
    [ 0, 1, 2, 2, 1, 0, 0, 1, 2, 2, 2, 2, 2, 2, 2, 2, 2, 2, 2, 2, 2, 2, 2, 2, 2, 2, 2, 2, 2, 2, 2, 2, 2, 2, 2, 2, 2, 2, 2, 2, 2, 2, 2, 2, 1, 0, 0, 1, 2, 2, 2, 2, 2, 2, 2, 2, 1, 0 ],
    [ 0, 1, 2, 2, 1, 0, 0, 1, 2, 2, 2, 2, 2, 2, 2, 2, 2, 2, 2, 2, 2, 2, 2, 2, 2, 2, 2, 2, 2, 2, 2, 2, 2, 2, 2, 2, 2, 2, 2, 2, 2, 2, 2, 2, 1, 0, 0, 1, 2, 2, 2, 2, 2, 2, 2, 2, 1, 0 ],
    [ 0, 1, 2, 2, 1, 0, 0, 1, 2, 2, 1, 1, 1, 1, 2, 2, 1, 1, 1, 1, 2, 2, 1, 1, 1, 1, 2, 2, 1, 1, 1, 1, 1, 1, 1, 1, 2, 2, 1, 1, 1, 1, 1, 1, 1, 0, 0, 1, 2, 2, 1, 1, 1, 1, 2, 2, 1, 0 ],
    [ 0, 1, 2, 2, 1, 0, 0, 1, 2, 2, 1, 0, 0, 1, 2, 2, 1, 0, 0, 1, 2, 2, 1, 0, 0, 1, 2, 2, 1, 0, 0, 0, 0, 0, 0, 1, 2, 2, 1, 0, 0, 0, 0, 0, 0, 0, 0, 1, 2, 2, 1, 0, 0, 1, 2, 2, 1, 0 ],
    [ 0, 1, 2, 2, 1, 0, 0, 1, 2, 2, 1, 0, 0, 1, 2, 2, 1, 0, 0, 1, 2, 2, 1, 0, 0, 1, 2, 2, 1, 0, 0, 0, 0, 0, 0, 1, 2, 2, 1, 0, 0, 0, 0, 0, 0, 0, 0, 1, 2, 2, 1, 0, 0, 1, 2, 2, 1, 0 ],
    [ 0, 1, 2, 2, 1, 1, 1, 1, 2, 2, 1, 1, 1, 1, 2, 2, 1, 1, 1, 1, 2, 2, 1, 1, 1, 1, 2, 2, 1, 1, 1, 1, 1, 1, 1, 1, 2, 2, 1, 1, 1, 1, 1, 1, 1, 1, 1, 1, 2, 2, 1, 0, 0, 1, 2, 2, 1, 0 ],
    [ 0, 1, 2, 2, 2, 2, 2, 2, 2, 2, 2, 2, 2, 2, 2, 2, 2, 2, 2, 2, 2, 2, 2, 2, 2, 2, 2, 2, 2, 2, 2, 2, 2, 2, 2, 2, 2, 2, 2, 2, 2, 2, 2, 2, 2, 2, 2, 2, 2, 2, 1, 0, 0, 1, 2, 2, 1, 0 ],
    [ 0, 1, 2, 2, 2, 2, 2, 2, 2, 2, 2, 2, 2, 2, 2, 2, 2, 2, 2, 2, 2, 2, 2, 2, 2, 2, 2, 2, 2, 2, 2, 2, 2, 2, 2, 2, 2, 2, 2, 2, 2, 2, 2, 2, 2, 2, 2, 2, 2, 2, 1, 0, 0, 1, 2, 2, 1, 0 ],
    [ 0, 1, 2, 2, 1, 1, 1, 1, 2, 2, 1, 1, 1, 1, 2, 2, 1, 1, 1, 1, 2, 2, 1, 1, 1, 1, 1, 1, 2, 2, 1, 1, 1, 1, 1, 1, 2, 2, 1, 1, 1, 1, 2, 2, 1, 1, 1, 1, 2, 2, 1, 0, 0, 1, 2, 2, 1, 0 ],
    [ 0, 1, 2, 2, 1, 0, 0, 1, 2, 2, 1, 0, 0, 1, 2, 2, 1, 0, 0, 1, 2, 2, 1, 0, 0, 0, 0, 1, 2, 2, 1, 0, 0, 0, 0, 1, 2, 2, 1, 0, 0, 1, 2, 2, 1, 0, 0, 1, 2, 2, 1, 0, 0, 1, 2, 2, 1, 0 ],
    [ 0, 1, 2, 2, 1, 0, 0, 1, 2, 2, 1, 0, 0, 1, 2, 2, 1, 0, 0, 1, 2, 2, 1, 0, 0, 0, 0, 1, 2, 2, 1, 0, 0, 0, 0, 1, 2, 2, 1, 0, 0, 1, 2, 2, 1, 0, 0, 1, 2, 2, 1, 0, 0, 1, 2, 2, 1, 0 ],
    [ 0, 1, 2, 2, 1, 0, 0, 1, 2, 2, 1, 1, 1, 1, 2, 2, 1, 0, 0, 1, 2, 2, 1, 0, 0, 0, 0, 1, 2, 2, 1, 0, 0, 0, 0, 1, 2, 2, 1, 0, 0, 1, 2, 2, 1, 1, 1, 1, 2, 2, 1, 1, 1, 1, 2, 2, 1, 0 ],
    [ 0, 1, 2, 2, 1, 0, 0, 1, 2, 2, 2, 2, 2, 2, 2, 2, 1, 0, 0, 1, 2, 2, 1, 0, 0, 0, 0, 1, 3, 3, 1, 0, 0, 0, 0, 1, 2, 2, 1, 0, 0, 1, 2, 2, 2, 2, 2, 2, 2, 2, 2, 2, 2, 2, 2, 2, 1, 0 ],
    [ 0, 1, 2, 2, 1, 0, 0, 1, 2, 2, 2, 2, 2, 2, 2, 2, 1, 0, 0, 1, 2, 2, 1, 0, 0, 0, 0, 1, 3, 3, 1, 0, 0, 0, 0, 1, 2, 2, 1, 0, 0, 1, 2, 2, 2, 2, 2, 2, 2, 2, 2, 2, 2, 2, 2, 2, 1, 0 ],
    [ 0, 1, 2, 2, 1, 0, 0, 1, 2, 2, 1, 1, 1, 1, 2, 2, 1, 0, 0, 1, 2, 2, 1, 0, 0, 0, 0, 1, 2, 2, 1, 0, 0, 0, 0, 1, 2, 2, 1, 0, 0, 1, 2, 2, 1, 1, 1, 1, 2, 2, 1, 1, 1, 1, 2, 2, 1, 0 ],
    [ 0, 1, 2, 2, 1, 0, 0, 1, 2, 2, 1, 0, 0, 1, 2, 2, 1, 0, 0, 1, 2, 2, 1, 0, 0, 0, 0, 1, 2, 2, 1, 0, 0, 0, 0, 1, 2, 2, 1, 0, 0, 1, 2, 2, 1, 0, 0, 1, 2, 2, 1, 0, 0, 1, 2, 2, 1, 0 ],
    [ 0, 1, 2, 2, 1, 0, 0, 1, 2, 2, 1, 0, 0, 1, 2, 2, 1, 0, 0, 1, 2, 2, 1, 0, 0, 0, 0, 1, 2, 2, 1, 0, 0, 0, 0, 1, 2, 2, 1, 0, 0, 1, 2, 2, 1, 0, 0, 1, 2, 2, 1, 0, 0, 1, 2, 2, 1, 0 ],
    [ 0, 1, 2, 2, 1, 1, 1, 1, 2, 2, 1, 1, 1, 1, 2, 2, 1, 1, 1, 1, 2, 2, 1, 1, 1, 1, 1, 1, 2, 2, 1, 1, 1, 1, 1, 1, 2, 2, 1, 1, 1, 1, 2, 2, 1, 0, 0, 1, 2, 2, 1, 1, 1, 1, 2, 2, 1, 0 ],
    [ 0, 1, 2, 2, 2, 2, 2, 2, 2, 2, 2, 2, 2, 2, 2, 2, 2, 2, 2, 2, 2, 2, 2, 2, 2, 2, 2, 2, 2, 2, 2, 2, 2, 2, 2, 2, 2, 2, 2, 2, 2, 2, 2, 2, 1, 0, 0, 1, 2, 2, 2, 2, 2, 2, 2, 2, 1, 0 ],
    [ 0, 1, 2, 2, 2, 2, 2, 2, 2, 2, 2, 2, 2, 2, 2, 2, 2, 2, 2, 2, 2, 2, 2, 2, 2, 2, 2, 2, 2, 2, 2, 2, 2, 2, 2, 2, 2, 2, 2, 2, 2, 2, 2, 2, 1, 0, 0, 1, 2, 2, 2, 2, 2, 2, 2, 2, 1, 0 ],
    [ 0, 1, 2, 2, 1, 1, 1, 1, 1, 1, 1, 1, 1, 1, 2, 2, 1, 1, 1, 1, 2, 2, 1, 1, 1, 1, 2, 2, 1, 1, 1, 1, 1, 1, 1, 1, 2, 2, 1, 1, 1, 1, 1, 1, 1, 0, 0, 1, 2, 2, 1, 1, 1, 1, 2, 2, 1, 0 ],
    [ 0, 1, 2, 2, 1, 0, 0, 0, 0, 0, 0, 0, 0, 1, 2, 2, 1, 0, 0, 1, 2, 2, 1, 0, 0, 1, 2, 2, 1, 0, 0, 0, 0, 0, 0, 1, 2, 2, 1, 0, 0, 0, 0, 0, 0, 0, 0, 1, 2, 2, 1, 0, 0, 1, 2, 2, 1, 0 ],
    [ 0, 1, 2, 2, 1, 0, 0, 0, 0, 0, 0, 0, 0, 1, 2, 2, 1, 0, 0, 1, 2, 2, 1, 0, 0, 1, 2, 2, 1, 0, 0, 0, 0, 0, 0, 1, 2, 2, 1, 0, 0, 0, 0, 0, 0, 0, 0, 1, 2, 2, 1, 0, 0, 1, 2, 2, 1, 0 ],
    [ 0, 1, 2, 2, 1, 0, 0, 1, 1, 1, 1, 1, 1, 1, 2, 2, 1, 1, 1, 1, 2, 2, 1, 1, 1, 1, 2, 2, 1, 1, 1, 1, 1, 1, 1, 1, 2, 2, 1, 1, 1, 1, 1, 1, 1, 1, 1, 1, 2, 2, 1, 1, 1, 1, 2, 2, 1, 0 ],
    [ 0, 1, 2, 2, 1, 0, 0, 1, 2, 2, 2, 2, 2, 2, 2, 2, 2, 2, 2, 2, 2, 2, 2, 2, 2, 2, 2, 2, 2, 2, 2, 2, 2, 2, 2, 2, 2, 2, 2, 2, 2, 2, 2, 2, 2, 2, 2, 2, 2, 2, 2, 2, 2, 2, 2, 2, 1, 0 ],
    [ 0, 1, 2, 2, 1, 0, 0, 1, 2, 2, 2, 2, 2, 2, 2, 2, 2, 2, 2, 2, 2, 2, 2, 2, 2, 2, 2, 2, 2, 2, 2, 2, 2, 2, 2, 2, 2, 2, 2, 2, 2, 2, 2, 2, 2, 2, 2, 2, 2, 2, 2, 2, 2, 2, 2, 2, 1, 0 ],
    [ 0, 1, 2, 2, 1, 0, 0, 1, 2, 2, 1, 1, 1, 1, 2, 2, 1, 1, 1, 1, 1, 1, 1, 1, 1, 1, 2, 2, 1, 1, 1, 1, 1, 1, 1, 1, 2, 2, 1, 1, 1, 1, 2, 2, 1, 1, 1, 1, 2, 2, 1, 1, 1, 1, 2, 2, 1, 0 ],
    [ 0, 1, 2, 2, 1, 0, 0, 1, 2, 2, 1, 0, 0, 1, 2, 2, 1, 0, 0, 0, 0, 0, 0, 0, 0, 1, 2, 2, 1, 0, 0, 0, 0, 0, 0, 1, 2, 2, 1, 0, 0, 1, 2, 2, 1, 0, 0, 1, 2, 2, 1, 0, 0, 1, 2, 2, 1, 0 ],
    [ 0, 1, 2, 2, 1, 0, 0, 1, 2, 2, 1, 0, 0, 1, 2, 2, 1, 0, 0, 0, 0, 0, 0, 0, 0, 1, 2, 2, 1, 0, 0, 0, 0, 0, 0, 1, 2, 2, 1, 0, 0, 1, 2, 2, 1, 0, 0, 1, 2, 2, 1, 0, 0, 1, 2, 2, 1, 0 ],
    [ 0, 1, 2, 2, 1, 1, 1, 1, 2, 2, 1, 1, 1, 1, 2, 2, 1, 1, 1, 1, 1, 1, 1, 1, 1, 1, 2, 2, 1, 1, 1, 1, 1, 1, 1, 1, 2, 2, 1, 1, 1, 1, 2, 2, 1, 1, 1, 1, 2, 2, 1, 0, 0, 1, 2, 2, 1, 0 ],
    [ 0, 1, 2, 2, 2, 2, 2, 2, 2, 2, 2, 2, 2, 2, 2, 2, 2, 2, 2, 2, 2, 2, 2, 2, 2, 2, 2, 2, 2, 2, 2, 2, 2, 2, 2, 2, 2, 2, 2, 2, 2, 2, 2, 2, 2, 2, 2, 2, 2, 2, 1, 0, 0, 1, 2, 2, 1, 0 ],
    [ 0, 1, 2, 2, 2, 2, 2, 2, 2, 2, 2, 2, 2, 2, 2, 2, 2, 2, 2, 2, 2, 2, 2, 2, 2, 2, 2, 2, 2, 2, 2, 2, 2, 2, 2, 2, 2, 2, 2, 2, 2, 2, 2, 2, 2, 2, 2, 2, 2, 2, 1, 0, 0, 1, 2, 2, 1, 0 ],
    [ 0, 1, 1, 1, 1, 1, 1, 1, 1, 1, 1, 1, 1, 1, 1, 1, 1, 1, 2, 2, 1, 1, 1, 1, 1, 1, 2, 2, 1, 1, 1, 1, 1, 1, 1, 1, 2, 2, 1, 1, 1, 1, 1, 1, 1, 1, 1, 1, 1, 1, 1, 0, 0, 1, 2, 2, 1, 0 ],
    [ 0, 0, 0, 0, 0, 0, 0, 0, 0, 0, 0, 0, 0, 0, 0, 0, 0, 1, 2, 2, 1, 0, 0, 0, 0, 1, 2, 2, 1, 0, 0, 0, 0, 0, 0, 1, 2, 2, 1, 0, 0, 0, 0, 0, 0, 0, 0, 0, 0, 0, 0, 0, 0, 1, 2, 2, 1, 0 ],
    [ 0, 0, 0, 0, 0, 0, 0, 0, 0, 0, 0, 0, 0, 0, 0, 0, 0, 1, 2, 2, 1, 0, 0, 0, 0, 1, 2, 2, 1, 0, 0, 0, 0, 0, 0, 1, 2, 2, 1, 0, 0, 0, 0, 0, 0, 0, 0, 0, 0, 0, 0, 0, 0, 1, 2, 2, 1, 0 ],
    [ 0, 1, 1, 1, 1, 1, 1, 1, 1, 1, 1, 1, 1, 1, 1, 1, 1, 1, 2, 2, 1, 1, 1, 1, 1, 1, 2, 2, 1, 1, 1, 1, 1, 1, 1, 1, 2, 2, 1, 1, 1, 1, 1, 1, 1, 1, 1, 1, 1, 1, 1, 1, 1, 1, 2, 2, 1, 0 ],
    [ 0, 1, 2, 2, 2, 2, 2, 2, 2, 2, 2, 2, 2, 2, 2, 2, 2, 2, 2, 2, 2, 2, 2, 2, 2, 2, 2, 2, 2, 2, 2, 2, 2, 2, 2, 2, 2, 2, 2, 2, 2, 2, 2, 2, 2, 2, 2, 2, 2, 2, 2, 2, 2, 2, 2, 2, 1, 0 ],
    [ 0, 1, 2, 2, 2, 2, 2, 2, 2, 2, 2, 2, 2, 2, 2, 2, 2, 2, 2, 2, 2, 2, 2, 2, 2, 2, 2, 2, 2, 2, 2, 2, 2, 2, 2, 2, 2, 2, 2, 2, 2, 2, 2, 2, 2, 2, 2, 2, 2, 2, 2, 2, 2, 2, 2, 2, 1, 0 ],
    [ 0, 1, 1, 1, 1, 1, 1, 1, 1, 1, 1, 1, 1, 1, 1, 1, 1, 1, 1, 1, 1, 1, 1, 1, 1, 1, 1, 1, 1, 1, 1, 1, 1, 1, 1, 1, 1, 1, 1, 1, 1, 1, 1, 1, 1, 1, 1, 1, 1, 1, 1, 1, 1, 1, 1, 1, 1, 0 ],
    [ 0, 0, 0, 0, 0, 0, 0, 0, 0, 0, 0, 0, 0, 0, 0, 0, 0, 0, 0, 0, 0, 0, 0, 0, 0, 0, 0, 0, 0, 0, 0, 0, 0, 0, 0, 0, 0, 0, 0, 0, 0, 0, 0, 0, 0, 0, 0, 0, 0, 0, 0, 0, 0, 0, 0, 0, 0, 0 ]
  ],
  "colliders": [
    {
      "pos": [ 0.0, 0.0 ],
      "size": [ 58.0, 1.0 ]
    },
    {
      "pos": [ 0.0, 0.0 ],
      "size": [ 1.0, 54.0 ]
    },
    {
      "pos": [ 0.0, 53.0 ],
      "size": [ 58.0, 1.0 ]
    },
    {
      "pos": [ 0.0, 47.0 ],
      "size": [ 17.0, 2.0 ]
    },
    {
      "pos": [ 21.0, 47.0 ],
      "size": [ 4.0, 2.0 ]
    },
    {
      "pos": [ 29.0, 47.0 ],
      "size": [ 6.0, 2.0 ]
    },
    {
      "pos": [ 39.0, 47.0 ],
      "size": [ 14.0, 2.0 ]
    },
    {
      "pos": [ 57.0, 0.0 ],
      "size": [ 1.0, 54.0 ]
    },
    {
      "pos": [ 51.0, 41.0 ],
      "size": [ 2.0, 8.0 ]
    },
    {
      "pos": [ 5.0, 5.0 ],
      "size": [ 2.0, 4.0 ]
    },
    {
      "pos": [ 5.0, 13.0 ],
      "size": [ 2.0, 6.0 ]
    },
    {
      "pos": [ 5.0, 23.0 ],
      "size": [ 2.0, 8.0 ]
    },
    {
      "pos": [ 5.0, 35.0 ],
      "size": [ 2.0, 8.0 ]
    },
    {
      "pos": [ 5.0, 35.0 ],
      "size": [ 8.0, 2.0 ]
    },
    {
      "pos": [ 11.0, 41.0 ],
      "size": [ 2.0, 2.0 ]
    },
    {
      "pos": [ 11.0, 29.0 ],
      "size": [ 2.0, 2.0 ]
    },
    {
      "pos": [ 11.0, 23.0 ],
      "size": [ 2.0, 2.0 ]
    },
    {
      "pos": [ 11.0, 17.0 ],
      "size": [ 2.0, 2.0 ]
    },
    {
      "pos": [ 11.0, 11.0 ],
      "size": [ 2.0, 2.0 ]
    },
    {
      "pos": [ 11.0, 5.0 ],
      "size": [ 8.0, 2.0 ]
    },
    {
      "pos": [ 17.0, 5.0 ],
      "size": [ 2.0, 8.0 ]
    },
    {
      "pos": [ 17.0, 17.0 ],
      "size": [ 2.0, 2.0 ]
    },
    {
      "pos": [ 17.0, 23.0 ],
      "size": [ 2.0, 8.0 ]
    },
    {
      "pos": [ 17.0, 35.0 ],
      "size": [ 2.0, 2.0 ]
    },
    {
      "pos": [ 17.0, 41.0 ],
      "size": [ 8.0, 2.0 ]
    },
    {
      "pos": [ 23.0, 35.0 ],
      "size": [ 2.0, 2.0 ]
    },
    {
      "pos": [ 23.0, 23.0 ],
      "size": [ 4.0, 8.0 ]
    },
    {
      "pos": [ 23.0, 17.0 ],
      "size": [ 2.0, 2.0 ]
    },
    {
      "pos": [ 23.0, 11.0 ],
      "size": [ 2.0, 2.0 ]
    },
    {
      "pos": [ 23.0, 5.0 ],
      "size": [ 2.0, 2.0 ]
    },
    {
      "pos": [ 29.0, 5.0 ],
      "size": [ 2.0, 2.0 ]
    },
    {
      "pos": [ 29.0, 11.0 ],
      "size": [ 6.0, 2.0 ]
    },
    {
      "pos": [ 29.0, 17.0 ],
      "size": [ 6.0, 2.0 ]
    },
    {
      "pos": [ 31.0, 23.0 ],
      "size": [ 4.0, 8.0 ]
    },
    {
      "pos": [ 29.0, 35.0 ],
      "size": [ 6.0, 2.0 ]
    },
    {
      "pos": [ 29.0, 41.0 ],
      "size": [ 6.0, 2.0 ]
    },
    {
      "pos": [ 35.0, 5.0 ],
      "size": [ 12.0, 2.0 ]
    },
    {
      "pos": [ 39.0, 11.0 ],
      "size": [ 2.0, 2.0 ]
    },
    {
      "pos": [ 39.0, 17.0 ],
      "size": [ 8.0, 2.0 ]
    },
    {
      "pos": [ 39.0, 23.0 ],
      "size": [ 2.0, 8.0 ]
    },
    {
      "pos": [ 39.0, 35.0 ],
      "size": [ 8.0, 2.0 ]
    },
    {
      "pos": [ 39.0, 41.0 ],
      "size": [ 2.0, 2.0 ]
    },
    {
      "pos": [ 45.0, 11.0 ],
      "size": [ 2.0, 8.0 ]
    },
    {
      "pos": [ 45.0, 23.0 ],
      "size": [ 2.0, 2.0 ]
    },
    {
      "pos": [ 45.0, 29.0 ],
      "size": [ 2.0, 8.0 ]
    },
    {
      "pos": [ 45.0, 41.0 ],
      "size": [ 2.0, 2.0 ]
    },
    {
      "pos": [ 51.0, 0.0 ],
      "size": [ 2.0, 7.0 ]
    },
    {
      "pos": [ 51.0, 11.0 ],
      "size": [ 2.0, 2.0 ]
    },
    {
      "pos": [ 51.0, 17.0 ],
      "size": [ 2.0, 8.0 ]
    },
    {
      "pos": [ 51.0, 29.0 ],
      "size": [ 2.0, 2.0 ]
    },
    {
      "pos": [ 51.0, 35.0 ],
      "size": [ 2.0, 2.0 ]
    }
  ],
  "player_spawn": [
    [ 4, 14 ],
    [ 21, 14 ]
  ],

  "enemies": [
    {
      "pos": [ 5, 1 ],
      "tank_texture": "Tron/Sprites/BlueTank.png",
      "gun_texture": "Tron/Sprites/BlueTankGun.png"
    },
    {
      "pos": [ 1, 15 ],
      "tank_texture": "Tron/Sprites/BlueTank.png",
      "gun_texture": "Tron/Sprites/GreenTankGun.png"
    },
    {
      "pos": [ 27, 5 ],
      "tank_texture": "Tron/Sprites/GreenTank.png",
      "gun_texture": "Tron/Sprites/GreenTankGun.png"
    },
    {
      "pos": [ 19, 9 ],
      "tank_texture": "Tron/Sprites/PinkTank.png",
      "gun_texture": "Tron/Sprites/RedTankGun.png"
    }
  ],

  "teleporter": {
    "from": [ 14, 13 ],
    "to": [

      [ 24, 20 ]
    ]
  }
}